WE           assets/HBONEY.xpm
         SO                assets/HBONEY.xpm

 
NO assets/HBONEY.xpm

C 0,0,0
F 50,50,25


   EA   assets/HBONEY.xpm             

11111111111111111111111111111111111111111111111111111111111111111111111111111111111111
10000000000000000000000000000000100000000000000000000000100000000000000000000000100001
1000000000000000000000000000000010000000000000000000000000000000000000000000000010N001
10000000000000000000000000000000100000000000000000000000100000000000000000000000100001
10000000000011100000000000000000100000000000000000000000100000000000000000000000111111
10000000000011100000000000000000000000000000000000000000100000000010000000000000000001
10000000000011100000000000000000100000000000000000000000100000000001000000000000000001
10000000000000000000000000000000100000000000000000000000100000000000000000000000000001
10000000000000000000000000000000100000000000000000000000100000000000000000000000000001
10000000000000000000000000000000100000000000000000000000100000000000000000000000000001
10000000000001111111111111111111011111111111111111111111111111111111111111111111101111
10000000000000000000000000000001000000000000010001001001110000000000000000000000000001
10000000000001000000000000000000001000000000111001001001010000000000000000000000000001
10000000000000000000000000000000000100000001000101101101110000000000000000000000000001
10000000000001000000000000000001000000000000000000000000000000000000000000000000000001
11111111111111111111111111111111111111111111111111111111111111111111111111111111111111