WE           textures/west
         SO               textures/south


                NO 
NO textures/north

F 255   , 214    ,   255
C 0,0,0


   EA   textures/east              

GF:123 abc

1111111111111111
1000100101000001
1000000000000001
1000000000000001
1000000000000001
10000000N0000001
1111111111111111